#o#####
#     #
# #t###
# #   #
# ###t#
#   #x#
#######