#####################################################
#o          #                 #   # # #   #         #
# ####### # # ### # # # ####### ### # # ### ##### # #
#       # #     # # # #         #               # # #
# ########### # # # # # ######### ##### # ####### ###
#           # # # # # #               # #       #   #
# # ##### ### ########### # ####### # ##### #########
# #     #   #           # #       # #     #         #
# # ### # # ##### # # ##### ######### ####### #######
# #   # # #     # # # #   #         #   #   # #     #
# # ### # ############# ################# ##### #####
# #   # # #       # # #           # #               #
### ### ### ### ### # # ####### # # # ######### # ###
#     #       # #   #         # #             # #   #
# # # ##### # ### ### ##### # # # # #################
# # #     # #         #   # # # # # # #       #     #
# ### ### # # ### ##### ########### # # ####### #####
# #     # # #   #           #     #                 #
### # # # # # ### ####### ### ####### # ### ##### # #
#   # # # # #   #       #           # #   #     # # #
# # # # ### # ##### ####### ##### # # # # ### ### ###
# # # # #   #     #       #     # # # # #   #   #   #
# ### ##### # # # # # # # # # # ### ### # # # ### ###
# #       # # # # # # # # # # #   #   # # # #   #   #
# ### ####### ### # # # # # ### ##### # ### # # # # #
# #         # # # # # # # # # #     # #   # # # # # #
# # # # # # ### # # # ####### ##### # ### ### # # # #
# # # # # #     # # #             # #   # #   # # # #
# # # # # ### # # # # # ####### # ### ### # # # # ###
# # # # #   # # # # # #       # #   # # # # # # #   #
# # ##### ######### # ######### # # # # # ### ##### #
# #   #           # #         # # # #   #   #     #x#
#####################################################