#########
#ot   # #
#t##### #
# # #   #
#t# #t###
#       #
#t#######
# t t tx#
#########