#######################
#o  #             #   #
# ### ####### ##### ###
#           #         #
# # # # # ######### ###
# # # # # #       #   #
# # # # # # ### # # # #
# # # # #     # # # # #
# # ####### # # # # ###
# #       # # # # #   #
# # ##### # ### ### ###
# #     # #   #   # # #
# # # # ### ######### #
# # # #   #     #   # #
# # ##### ####### ### #
# #     #             #
# # ########### ### ###
# #         # #   #   #
# # # # # ### #########
# # # # #             #
# # # ### # ### #######
# # #   # #   #      x#
#######################