#############
#o        # #
# # # # ### #
# # # #   # #
#t# # # ### #
# # # #     #
# ### # ### #
#t  # #   # #
# # # # ### #
# # #t#   # #
#t### #####t#
#   #     #x#
#############