#################
#o              #
# ### # # # # # #
#   # # # # # # #
# # # # # ##### #
# # # # #     # #
# ### # # # ### #
#   # # # #   # #
# ##### # # # ###
#   #   # # #   #
# ### # # # # ###
#   # # # # #   #
# # ### ### # # #
# #   # #   # # #
# ######### ### #
#         #   #x#
#################