#########################
#o              # # #   #
# # # ##### # ### # # ###
# # #     # #   #       #
# ### # # # # ### ### # #
#   # # # # #       # # #
# # # ##### ##### ### ###
# # #     #     #   #   #
# ### # # ### # # # # ###
#   # # #   # # # # #   #
# ### # # ##### # # #####
#   # # #     # # #     #
# ### # # # ### ### #####
#   # # # #   #   #     #
# # # ### ### # ### #####
# # #   #   # #  t#     #
# # # # # # ##### # #####
# # # # # #     # #     #
# ### # ### # # # # # ###
#   # #   # # # # # #   #
# # # # ##### # # ### # #
# # # #     # # #   # # #
# # # # ############### #
# # # #             #  x#
#########################